"ID";"Werkzaamheden";"Opdrachtgever";"Perioden";"TotaalAantalVerleendeBouwvergunningen_2";"AantalBouwvergunningenWoningbouw_4";"AantalBouwvergunningenUtiliteitsbouw_6"
"0";"0";"0";"1990MM01";"    3084";"    1837";"    1247"
"1";"0";"0";"1990MM02";"    2832";"    1652";"    1180"
"2";"0";"0";"1990MM03";"    3261";"    1867";"    1394"
"4";"0";"0";"1990MM04";"    3346";"    1948";"    1398"
"5";"0";"0";"1990MM05";"    3230";"    1827";"    1403"
"6";"0";"0";"1990MM06";"    3450";"    2022";"    1428"
"8";"0";"0";"1990MM07";"    3701";"    2115";"    1586"
"9";"0";"0";"1990MM08";"    2759";"    1556";"    1203"
"10";"0";"0";"1990MM09";"    3132";"    1855";"    1277"
"12";"0";"0";"1990MM10";"    3329";"    1931";"    1398"
"13";"0";"0";"1990MM11";"    3073";"    1874";"    1199"
"14";"0";"0";"1990MM12";"    2648";"    1523";"    1125"
"17";"0";"0";"1991MM01";"    2843";"    1564";"    1279"
"18";"0";"0";"1991MM02";"    2632";"    1504";"    1128"
"19";"0";"0";"1991MM03";"    2758";"    1537";"    1221"
"21";"0";"0";"1991MM04";"    2894";"    1664";"    1230"
"22";"0";"0";"1991MM05";"    3127";"    1706";"    1421"
"23";"0";"0";"1991MM06";"    3169";"    1805";"    1364"
"25";"0";"0";"1991MM07";"    3484";"    2028";"    1456"
"26";"0";"0";"1991MM08";"    2937";"    1625";"    1312"
"27";"0";"0";"1991MM09";"    3175";"    1897";"    1278"
"29";"0";"0";"1991MM10";"    3434";"    2080";"    1354"
"30";"0";"0";"1991MM11";"    3074";"    1782";"    1292"
"31";"0";"0";"1991MM12";"    2886";"    1732";"    1154"
"34";"0";"0";"1992MM01";"    2695";"    1584";"    1111"
"35";"0";"0";"1992MM02";"    3112";"    1833";"    1279"
"36";"0";"0";"1992MM03";"    3407";"    1981";"    1426"
"38";"0";"0";"1992MM04";"    3037";"    1773";"    1264"
"39";"0";"0";"1992MM05";"    3007";"    1773";"    1234"
"40";"0";"0";"1992MM06";"    3817";"    2233";"    1584"
"42";"0";"0";"1992MM07";"    3434";"    1998";"    1436"
"43";"0";"0";"1992MM08";"    2878";"    1681";"    1197"
"44";"0";"0";"1992MM09";"    3199";"    1932";"    1267"
"46";"0";"0";"1992MM10";"    3125";"    1956";"    1169"
"47";"0";"0";"1992MM11";"    2814";"    1731";"    1083"
"48";"0";"0";"1992MM12";"    2565";"    1621";"     944"
"51";"0";"0";"1993MM01";"    2578";"    1574";"    1004"
"52";"0";"0";"1993MM02";"    2627";"    1677";"     950"
"53";"0";"0";"1993MM03";"    3049";"    1919";"    1130"
"55";"0";"0";"1993MM04";"    2767";"    1735";"    1032"
"56";"0";"0";"1993MM05";"    2846";"    1860";"     986"
"57";"0";"0";"1993MM06";"    3375";"    2311";"    1064"
"59";"0";"0";"1993MM07";"    3332";"    2253";"    1079"
"60";"0";"0";"1993MM08";"    2908";"    1922";"     986"
"61";"0";"0";"1993MM09";"    2969";"    1969";"    1000"
"63";"0";"0";"1993MM10";"    3030";"    2029";"    1001"
"64";"0";"0";"1993MM11";"    2997";"    2027";"     970"
"65";"0";"0";"1993MM12";"    3033";"    2042";"     991"
"68";"0";"0";"1994MM01";"    2587";"    1754";"     833"
"69";"0";"0";"1994MM02";"    2820";"    1967";"     853"
"70";"0";"0";"1994MM03";"    3053";"    2082";"     971"
"72";"0";"0";"1994MM04";"    2960";"    2045";"     915"
"73";"0";"0";"1994MM05";"    3316";"    2268";"    1048"
"74";"0";"0";"1994MM06";"    3616";"    2440";"    1176"
"76";"0";"0";"1994MM07";"    3530";"    2399";"    1131"
"77";"0";"0";"1994MM08";"    3057";"    1939";"    1118"
"78";"0";"0";"1994MM09";"    2959";"    1907";"    1052"
"80";"0";"0";"1994MM10";"    3156";"    2121";"    1035"
"81";"0";"0";"1994MM11";"    2870";"    1921";"     949"
"82";"0";"0";"1994MM12";"    2853";"    1867";"     986"
"85";"0";"0";"1995MM01";"    2728";"    1778";"     950"
"86";"0";"0";"1995MM02";"    2602";"    1715";"     887"
"87";"0";"0";"1995MM03";"    2836";"    1804";"    1032"
"89";"0";"0";"1995MM04";"    2665";"    1626";"    1039"
"90";"0";"0";"1995MM05";"    3177";"    2006";"    1171"
"91";"0";"0";"1995MM06";"    3312";"    2099";"    1213"
"93";"0";"0";"1995MM07";"    2805";"    1763";"    1042"
"94";"0";"0";"1995MM08";"    3084";"    1918";"    1166"
"95";"0";"0";"1995MM09";"    2752";"    1720";"    1032"
"97";"0";"0";"1995MM10";"    2842";"    1773";"    1069"
"98";"0";"0";"1995MM11";"    2953";"    1807";"    1146"
"99";"0";"0";"1995MM12";"    2802";"    1778";"    1024"
"102";"0";"0";"1996MM01";"    2656";"    1644";"    1012"
"103";"0";"0";"1996MM02";"    2752";"    1658";"    1094"
"104";"0";"0";"1996MM03";"    2658";"    1655";"    1003"
"106";"0";"0";"1996MM04";"    2750";"    1655";"    1095"
"107";"0";"0";"1996MM05";"    2975";"    1872";"    1103"
"108";"0";"0";"1996MM06";"    3526";"    2262";"    1264"
"110";"0";"0";"1996MM07";"    3176";"    1927";"    1249"
"111";"0";"0";"1996MM08";"    3054";"    1939";"    1115"
"112";"0";"0";"1996MM09";"    3371";"    2124";"    1247"
"114";"0";"0";"1996MM10";"    3145";"    1881";"    1264"
"115";"0";"0";"1996MM11";"    3119";"    1939";"    1180"
"116";"0";"0";"1996MM12";"    2634";"    1655";"     979"
"119";"0";"0";"1997MM01";"    2474";"    1548";"     926"
"120";"0";"0";"1997MM02";"    2411";"    1496";"     915"
"121";"0";"0";"1997MM03";"    2770";"    1699";"    1071"
"123";"0";"0";"1997MM04";"    3129";"    1911";"    1218"
"124";"0";"0";"1997MM05";"    2835";"    1726";"    1109"
"125";"0";"0";"1997MM06";"    3540";"    2152";"    1388"
"127";"0";"0";"1997MM07";"    3092";"    1807";"    1285"
"128";"0";"0";"1997MM08";"    2855";"    1658";"    1197"
"129";"0";"0";"1997MM09";"    3432";"    1986";"    1446"
"131";"0";"0";"1997MM10";"    3478";"    2110";"    1368"
"132";"0";"0";"1997MM11";"    3086";"    1739";"    1347"
"133";"0";"0";"1997MM12";"    3172";"    1876";"    1296"
"136";"0";"0";"1998MM01";"    2519";"    1452";"    1067"
"137";"0";"0";"1998MM02";"    2649";"    1594";"    1055"
"138";"0";"0";"1998MM03";"    3168";"    1865";"    1303"
"140";"0";"0";"1998MM04";"    2765";"    1607";"    1158"
"141";"0";"0";"1998MM05";"    2812";"    1629";"    1183"
"142";"0";"0";"1998MM06";"    3480";"    2011";"    1469"
"144";"0";"0";"1998MM07";"    3293";"    1876";"    1417"
"145";"0";"0";"1998MM08";"    2758";"    1552";"    1206"
"146";"0";"0";"1998MM09";"    3698";"    2135";"    1563"
"148";"0";"0";"1998MM10";"    2916";"    1653";"    1263"
"149";"0";"0";"1998MM11";"    2886";"    1590";"    1296"
"150";"0";"0";"1998MM12";"    3426";"    2009";"    1417"
"153";"0";"0";"1999MM01";"    2497";"    1403";"    1094"
"154";"0";"0";"1999MM02";"    2572";"    1497";"    1075"
"155";"0";"0";"1999MM03";"    3215";"    1873";"    1342"
"157";"0";"0";"1999MM04";"    2941";"    1726";"    1215"
"158";"0";"0";"1999MM05";"    3023";"    1673";"    1350"
"159";"0";"0";"1999MM06";"    3318";"    1924";"    1394"
"161";"0";"0";"1999MM07";"    3082";"    1766";"    1316"
"162";"0";"0";"1999MM08";"    3058";"    1803";"    1255"
"163";"0";"0";"1999MM09";"    3130";"    1797";"    1333"
"165";"0";"0";"1999MM10";"    2896";"    1666";"    1230"
"166";"0";"0";"1999MM11";"    3344";"    1969";"    1375"
"167";"0";"0";"1999MM12";"    3492";"    2132";"    1360"
"170";"0";"0";"2000MM01";"    2622";"    1586";"    1036"
"171";"0";"0";"2000MM02";"    2996";"    1731";"    1265"
"172";"0";"0";"2000MM03";"    3330";"    2069";"    1261"
"174";"0";"0";"2000MM04";"    2842";"    1684";"    1158"
"175";"0";"0";"2000MM05";"    3190";"    1872";"    1318"
"176";"0";"0";"2000MM06";"    3167";"    1840";"    1327"
"178";"0";"0";"2000MM07";"    2944";"    1684";"    1260"
"179";"0";"0";"2000MM08";"    3142";"    1777";"    1365"
"180";"0";"0";"2000MM09";"    2909";"    1658";"    1251"
"182";"0";"0";"2000MM10";"    2836";"    1597";"    1239"
"183";"0";"0";"2000MM11";"    2742";"    1538";"    1204"
"184";"0";"0";"2000MM12";"    2690";"    1588";"    1102"
"187";"0";"0";"2001MM01";"    3285";"    1993";"    1292"
"188";"0";"0";"2001MM02";"    3118";"    1760";"    1358"
"189";"0";"0";"2001MM03";"    3172";"    1871";"    1301"
"191";"0";"0";"2001MM04";"    2700";"    1574";"    1126"
"192";"0";"0";"2001MM05";"    3211";"    1886";"    1325"
"193";"0";"0";"2001MM06";"    3057";"    1816";"    1241"
"195";"0";"0";"2001MM07";"    3253";"    1833";"    1420"
"196";"0";"0";"2001MM08";"    2581";"    1467";"    1114"
"197";"0";"0";"2001MM09";"    2832";"    1570";"    1262"
"199";"0";"0";"2001MM10";"    3164";"    1795";"    1369"
"200";"0";"0";"2001MM11";"    2471";"    1425";"    1046"
"201";"0";"0";"2001MM12";"    2216";"    1284";"     932"
"204";"0";"0";"2002MM01";"    1977";"    1129";"     848"
"205";"0";"0";"2002MM02";"    2043";"    1201";"     842"
"206";"0";"0";"2002MM03";"    2219";"    1319";"     900"
"208";"0";"0";"2002MM04";"    2364";"    1353";"    1011"
"209";"0";"0";"2002MM05";"    2400";"    1436";"     964"
"210";"0";"0";"2002MM06";"    2624";"    1579";"    1045"
"212";"0";"0";"2002MM07";"    2404";"    1403";"    1001"
"213";"0";"0";"2002MM08";"    2344";"    1475";"     869"
"214";"0";"0";"2002MM09";"    2320";"    1368";"     952"
"216";"0";"0";"2002MM10";"    2889";"    1674";"    1215"
"217";"0";"0";"2002MM11";"    2722";"    1673";"    1049"
"218";"0";"0";"2002MM12";"    2984";"    1947";"    1037"
"221";"0";"0";"2003MM01";"    1953";"    1228";"     725"
"222";"0";"0";"2003MM02";"    2065";"    1285";"     780"
"223";"0";"0";"2003MM03";"    2899";"    1884";"    1015"
"225";"0";"0";"2003MM04";"    2217";"    1393";"     824"
"226";"0";"0";"2003MM05";"    1827";"    1100";"     727"
"227";"0";"0";"2003MM06";"    2588";"    1487";"    1101"
"229";"0";"0";"2003MM07";"    2166";"    1267";"     899"
"230";"0";"0";"2003MM08";"    2027";"    1156";"     871"
"231";"0";"0";"2003MM09";"    2471";"    1443";"    1028"
"233";"0";"0";"2003MM10";"    2401";"    1391";"    1010"
"234";"0";"0";"2003MM11";"    2184";"    1353";"     831"
"235";"0";"0";"2003MM12";"    3377";"    2140";"    1237"
"238";"0";"0";"2004MM01";"    1920";"    1175";"     745"
"239";"0";"0";"2004MM02";"    1957";"    1141";"     816"
"240";"0";"0";"2004MM03";"    2506";"    1505";"    1001"
"242";"0";"0";"2004MM04";"    2072";"    1234";"     838"
"243";"0";"0";"2004MM05";"    2092";"    1284";"     808"
"244";"0";"0";"2004MM06";"    2883";"    1760";"    1123"
"246";"0";"0";"2004MM07";"    2725";"    1703";"    1022"
"247";"0";"0";"2004MM08";"    2945";"    1779";"    1166"
"248";"0";"0";"2004MM09";"    2516";"    1531";"     985"
"250";"0";"0";"2004MM10";"    2472";"    1530";"     942"
"251";"0";"0";"2004MM11";"    3023";"    1932";"    1091"
"252";"0";"0";"2004MM12";"    4350";"    2749";"    1601"
"255";"0";"0";"2005MM01";"    2048";"    1293";"     755"
"256";"0";"0";"2005MM02";"    1927";"    1204";"     723"
"257";"0";"0";"2005MM03";"    2369";"    1469";"     900"
"259";"0";"0";"2005MM04";"    2295";"    1447";"     848"
"260";"0";"0";"2005MM05";"    2535";"    1557";"     978"
"261";"0";"0";"2005MM06";"    3003";"    1853";"    1150"
"263";"0";"0";"2005MM07";"    2489";"    1546";"     943"
"264";"0";"0";"2005MM08";"    2436";"    1565";"     871"
"265";"0";"0";"2005MM09";"    2536";"    1579";"     957"
"267";"0";"0";"2005MM10";"    3124";"    1975";"    1149"
"268";"0";"0";"2005MM11";"    3266";"    2030";"    1236"
"269";"0";"0";"2005MM12";"    3168";"    2014";"    1154"
"272";"0";"0";"2006MM01";"    2205";"    1439";"     766"
"273";"0";"0";"2006MM02";"    2335";"    1488";"     847"
"274";"0";"0";"2006MM03";"    3158";"    2112";"    1046"
"276";"0";"0";"2006MM04";"    2534";"    1631";"     903"
"277";"0";"0";"2006MM05";"    2459";"    1589";"     870"
"278";"0";"0";"2006MM06";"    3131";"    1959";"    1172"
"280";"0";"0";"2006MM07";"    2575";"    1582";"     993"
"281";"0";"0";"2006MM08";"    2671";"    1662";"    1009"
"282";"0";"0";"2006MM09";"    3398";"    2071";"    1327"
"284";"0";"0";"2006MM10";"    2320";"    1398";"     922"
"285";"0";"0";"2006MM11";"    2889";"    1835";"    1054"
"286";"0";"0";"2006MM12";"    3830";"    2414";"    1416"
"289";"0";"0";"2007MM01";"    2311";"    1402";"     909"
"290";"0";"0";"2007MM02";"    2037";"    1273";"     764"
"291";"0";"0";"2007MM03";"    3020";"    1862";"    1158"
"293";"0";"0";"2007MM04";"    2538";"    1570";"     968"
"294";"0";"0";"2007MM05";"    2459";"    1466";"     993"
"295";"0";"0";"2007MM06";"    3254";"    1972";"    1282"
"297";"0";"0";"2007MM07";"    3197";"    1941";"    1256"
"298";"0";"0";"2007MM08";"    3039";"    1870";"    1169"
"299";"0";"0";"2007MM09";"    3665";"    2203";"    1462"
"301";"0";"0";"2007MM10";"    2841";"    1716";"    1125"
"302";"0";"0";"2007MM11";"    3116";"    1990";"    1126"
"303";"0";"0";"2007MM12";"    3313";"    2058";"    1255"
"306";"0";"0";"2008MM01";"    2479";"    1513";"     966"
"307";"0";"0";"2008MM02";"    2193";"    1277";"     916"
"308";"0";"0";"2008MM03";"    2856";"    1691";"    1165"
"310";"0";"0";"2008MM04";"    2856";"    1711";"    1145"
"311";"0";"0";"2008MM05";"    2775";"    1684";"    1091"
"312";"0";"0";"2008MM06";"    2762";"    1619";"    1143"
"314";"0";"0";"2008MM07";"    2954";"    1669";"    1285"
"315";"0";"0";"2008MM08";"    3172";"    1952";"    1220"
"316";"0";"0";"2008MM09";"    3349";"    2032";"    1317"
"318";"0";"0";"2008MM10";"    2919";"    1818";"    1101"
"319";"0";"0";"2008MM11";"    3253";"    1948";"    1305"
"320";"0";"0";"2008MM12";"    3167";"    1949";"    1218"
"323";"0";"0";"2009MM01";"    2050";"    1234";"     816"
"324";"0";"0";"2009MM02";"    1955";"    1129";"     826"
"325";"0";"0";"2009MM03";"    2330";"    1323";"    1007"
"327";"0";"0";"2009MM04";"    2403";"    1414";"     989"
"328";"0";"0";"2009MM05";"    2126";"    1245";"     881"
"329";"0";"0";"2009MM06";"    2237";"    1273";"     964"
"331";"0";"0";"2009MM07";"    2683";"    1539";"    1144"
"332";"0";"0";"2009MM08";"    1852";"    1107";"     745"
"333";"0";"0";"2009MM09";"    2598";"    1491";"    1107"
"335";"0";"0";"2009MM10";"    2291";"    1335";"     956"
"336";"0";"0";"2009MM11";"    2137";"    1255";"     882"
"337";"0";"0";"2009MM12";"    3068";"    1872";"    1196"
"340";"0";"0";"2010MM01";"    1559";"     939";"     620"
"341";"0";"0";"2010MM02";"    1527";"     927";"     600"
"342";"0";"0";"2010MM03";"    2023";"    1222";"     801"
"344";"0";"0";"2010MM04";"    1811";"    1077";"     734"
"345";"0";"0";"2010MM05";"    1878";"    1086";"     792"
"346";"0";"0";"2010MM06";"    2279";"    1349";"     930"
"348";"0";"0";"2010MM07";"    2710";"    1587";"    1123"
"349";"0";"0";"2010MM08";"    2037";"    1172";"     865"
"350";"0";"0";"2010MM09";"    2076";"    1230";"     846"
"352";"0";"0";"2010MM10";"    1828";"    1072";"     756"
"353";"0";"0";"2010MM11";"    3128";"    1836";"    1292"
"354";"0";"0";"2010MM12";"    2285";"    1393";"     892"
"357";"0";"0";"2011MM01";"    1657";"    1064";"     593"
"358";"0";"0";"2011MM02";"    1691";"    1131";"     560"
"359";"0";"0";"2011MM03";"    2112";"    1386";"     726"
"361";"0";"0";"2011MM04";"    1815";"    1110";"     705"
"362";"0";"0";"2011MM05";"    1566";"     921";"     645"
"363";"0";"0";"2011MM06";"    1794";"    1029";"     765"
"365";"0";"0";"2011MM07";"    1871";"    1064";"     807"
"366";"0";"0";"2011MM08";"    1368";"     809";"     559"
"367";"0";"0";"2011MM09";"    2155";"    1262";"     893"
"369";"0";"0";"2011MM10";"    2408";"    1394";"    1014"
"370";"0";"0";"2011MM11";"    2292";"    1312";"     980"
"371";"0";"0";"2011MM12";"    1988";"    1108";"     880"
"374";"0";"0";"2012MM01";"    1173";"     651";"     522"
"375";"0";"0";"2012MM02";"    1354";"     802";"     552"
"376";"0";"0";"2012MM03";"    1475";"     829";"     646"
"378";"0";"0";"2012MM04";"    1271";"     716";"     555"
"379";"0";"0";"2012MM05";"    1439";"     774";"     665"
"380";"0";"0";"2012MM06";"    1847";"    1032";"     815"
"382";"0";"0";"2012MM07";"    1648";"     917";"     731"
"383";"0";"0";"2012MM08";"    1349";"     740";"     609"
"384";"0";"0";"2012MM09";"    1634";"     882";"     752"
"386";"0";"0";"2012MM10";"    1468";"     803";"     665"
"387";"0";"0";"2012MM11";"    1525";"     884";"     641"
"388";"0";"0";"2012MM12";"    1359";"     790";"     569"
"391";"0";"0";"2013MM01";"    1133";"     612";"     521"
"392";"0";"0";"2013MM02";"    1035";"     590";"     445"
"393";"0";"0";"2013MM03";"    1355";"     729";"     626"
"395";"0";"0";"2013MM04";"    1313";"     689";"     624"
"396";"0";"0";"2013MM05";"    1414";"     785";"     629"
"397";"0";"0";"2013MM06";"    1419";"     760";"     659"
"399";"0";"0";"2013MM07";"    1546";"     830";"     716"
"400";"0";"0";"2013MM08";"    1094";"     586";"     508"
"401";"0";"0";"2013MM09";"    1577";"     843";"     734"
"403";"0";"0";"2013MM10";"    1399";"     836";"     563"
"404";"0";"0";"2013MM11";"    1456";"     849";"     607"
"405";"0";"0";"2013MM12";"    1351";"     744";"     607"
"408";"0";"0";"2014MM01";"    1590";"     859";"     731"
"409";"0";"0";"2014MM02";"    1286";"     752";"     534"
"410";"0";"0";"2014MM03";"    1422";"     844";"     578"
"412";"0";"0";"2014MM04";"    1422";"     799";"     623"
"413";"0";"0";"2014MM05";"    1383";"     798";"     585"
"414";"0";"0";"2014MM06";"    1511";"     906";"     605"
"416";"0";"0";"2014MM07";"    1783";"    1077";"     706"
"417";"0";"0";"2014MM08";"    1242";"     773";"     469"
"418";"0";"0";"2014MM09";"    1604";"    1033";"     571"
"420";"0";"0";"2014MM10";"    1533";"     944";"     589"
"421";"0";"0";"2014MM11";"    1432";"     937";"     495"
"422";"0";"0";"2014MM12";"    1798";"    1158";"     640"
"425";"0";"0";"2015MM01";"    1358";"     921";"     437"
"426";"0";"0";"2015MM02";"    1913";"    1429";"     484"
"427";"0";"0";"2015MM03";"    1729";"    1224";"     505"
"429";"0";"0";"2015MM04";"    1852";"    1243";"     609"
"430";"0";"0";"2015MM05";"    1351";"     880";"     471"
"431";"0";"0";"2015MM06";"    1672";"    1057";"     615"
"433";"0";"0";"2015MM07";"    1477";"     917";"     560"
"434";"0";"0";"2015MM08";"    1504";"     936";"     568"
"435";"0";"0";"2015MM09";"    1602";"    1032";"     570"
"437";"0";"0";"2015MM10";"    1509";"    1011";"     498"
"438";"0";"0";"2015MM11";"    1659";"    1101";"     558"
"439";"0";"0";"2015MM12";"    1662";"    1129";"     533"
"442";"0";"0";"2016MM01";"    1224";"     875";"     349"
"443";"0";"0";"2016MM02";"    1679";"    1151";"     528"
"444";"0";"0";"2016MM03";"    1529";"    1050";"     479"
"446";"0";"0";"2016MM04";"    1776";"    1185";"     591"
"447";"0";"0";"2016MM05";"    1528";"    1020";"     508"
"448";"0";"0";"2016MM06";"    1946";"    1322";"     624"
"450";"0";"0";"2016MM07";"    1909";"    1301";"     608"
"451";"0";"0";"2016MM08";"    1685";"    1162";"     523"
"452";"0";"0";"2016MM09";"    1937";"    1398";"     539"
"454";"0";"0";"2016MM10";"    1685";"    1163";"     522"
"455";"0";"0";"2016MM11";"    1935";"    1345";"     590"
"456";"0";"0";"2016MM12";"    2087";"    1509";"     578"
